Regret = сожалеть
Obviously = очевидно
Folk = люди
Disaster = катастрофа
Very second = в ту же секунду
Rather = достаточно
Responsibility = отвественность
Revenge = месть
Enough = достаточно
Each other = друг с другом
Define = определять
Suppose = предпологать 
Certain = определенно
Cause = причина
Ugly = некрасивый
Get on well = ладить с кем то
Determine = решит
Compare = сравнивать
Dizzy = головокружение
Worn = изношенный
Strangers = незнакомцы
Ever = когда либо
No doubt = без сомнения
Scare = бояться пугать
Carry = нести
Canvas = полотно
Pleasure = удовольствие
Guess = угадывать
Carry out = выполнять
Fate = судьба
Reduce = сокращать
Chase = выгонять
Handle = держать в руках
Necessary = обязательный
Soul = душа
Influence = влияние
Seem = казаться
Proud = гордится
Mankind = человечество
Prefer = предпологать
Grab = схватить
I must admit = я должен признать
Confident = уверенный
Sole = единственный
Rest = отдых
Weird = странно 
Relate = отношения
Struck = ударил
Damn = проклятие 
Almost = почти
Blind = слепой
Against = против
Cheated = обманул
Consequences = последствия
Abroad = за границу
Shame = стыд
Own = собственная
Unfortunately = к несчастью
Tricky = хитрый
Tends to = как правило обычно
Be aware = будь в курсе
Fit = соответсвовать
Afraid = испуганный
Slave = раб
Expect = ожидание
Few = мало
Soon = скоро
Bother = бесит
Arrange = организовать
Claim = требовать
